
Episode 1

crucial moment : 중요한 순간
colors: 성조기
vicinity:근처,비슷한것
quid pro quo : 대가, 보상 (Latin, "what for what")
walk all over : 말을 안듣다
hold dear : 가치있게 여기다
greatest hits : best of album
Secretary:장관
the Capitol : 국회의사당
Hey, I'm slaving over here. : 내가 열심히 하고 있잖아.
State of the Union: 연두교서. 연초 미대통령의 국정연설.
dubstep track : A genre of electronic music 

make us proud : used about someone who feels so proud that they think they are better than other people. 잘하고 와
Congress : 하원 (the Senate : (미국의)상원)
Cabinet : 내각
slip someone something : 슬쩍 찔러주다.
housing reform : 주택 개혁
work one's ass off : 힘들게 일하다.
backfire : 역효과,맞불
Secretary of Housing and Urban Development. 주택도시개발 장관
get someone wrong : 오해하다
Chief of Staff : 참모장, 수석보좌관
muddled : 뒤죽박죽인 
hazard a guess : 조심스럽게 추측하다
initiative : (법안)발의,개시,창시,창의
ambassadorship : 대사직
all the trimmings (그밖에) 모두.
pleasure : 의지,기호,기쁨,즐거움
pleasure of the President. : 대통령의 의지
play someone's game : 장단을 맞추다

